PMT.#TM#T###
T#.STTP.P...
M#...#.T.T.#
T#P#.....P#.
PM.##.PPM#T.
#P.#T.MTM.TP
#.#M.P.T.MM#
T#...PT..A..
.MM#M.#..#..
##T#.TT.T...
#PM.P..#.PT#
....M#E.#MM#